1111111111111111111111111
1200000000010001000000021
1010000110010001000000101
1011100000010001110011101
1010000110010000000000101
1000000100010110001110001
1000100100000000000010001
1000100000110011000011001
1000111000100001000000001
1010000000100001001011001
1010000100100001001000001
1010011100100001001011001
1000000100111111001000001
1111000100000000001011001
1000000000000000000000001
1011111000011100010011001
1000000000001000010000001
1001101110101000011100111
1001001000100000000100001
1000001000101110000100101
1010001000000100000000101
1011101001000100111011101
1010001001000100100000101
1200000001000000000000021
1111111111111111111111111
