111111111111111111111111111111
120000010000000000000100000021
101000000011111111100000000101
101000000000001000001111000101
101110100000001011000000011101
101000101111101011001000000101
101000100000000011001001110101
100000000000000000001000000001
100011111100110011001001110111
101000000000100001001000000001
101010010110100001001001110101
101010010110100001001000000101
101010010110100001001001110101
101010010110111111001000000101
100000010000000000001000000001
111111111111100010001001111111
100000001000000010001000000001
100100001001111010001001010101
100100001000000000001001010101
100101101011111111000001010101
100100001010000000001001010101
100100001010000000001000000101
100001000010001000001011110101
101001000010001011101000000001
101001010010111011101111111001
101001010000111011100001000001
100001010000111000000001011101
101111011010111110000001011101
120000000010000000000001000021
111111111111111111111111111111